111111111111111111111111111111111111111111111111111111111
100000000000000000000000000000000000000000000000000000001
12E000000000000000000000000000000000000000000000000000001
1WWWWWWWWWWWWWWWWWWWWWWWWWWWWWWWWWWWWYWWWYWWWYWWWYWWWWWY1
1000000000000000000000000000000000000Y000Y000Y000Y00000Y1
1000000000000000000C00000C00000000000Y000Y000Y000Y00000Y1
10000YWWWWWWWWWWWWWWWWWY0000000000YWWWYWWWYWWWYWWWYWYWWW1
10000Y00000000000000000Y0000000000Y000Y000Y000Y000Y0Y0001
10000Y00000000000000000Y0000000000Y000Y000Y000Y000Y0Y0001
10000Y00000000000000000Y0000000000Y000Y000Y000Y000Y0Y0001
10C00Y00000000000000000Y0000000000Y000Y000Y000Y000Y0Y0001
10000YWWWWWWWWWWWWWWWWWY0000000000YWWWYWWWYWWWYWWWYWYWWW1
10000Y00000000000000000Y0000000000Y000Y000Y000Y000Y0Y0001
10000Y00000000000000000Y0000000000Y000Y000Y000Y000Y0Y0001
10000Y00000000000000000Y0000000000Y000Y000Y000Y000Y0Y0001
10C00Y00000000000000000Y0000000000Y000Y000Y000Y000Y0Y0001
1WWWWWWWWWWWWY000000000Y0000000000Y000Y000Y000Y000Y0Y0001
1000000000000Y000000000Y0000000000Y000Y000Y000Y000Y0Y0001
1000000000000Y000000000WWWWWWWWWWWW000W000W000W000W0W0001
1000000P00000Y0000000000000000000000000000000000000000001
111111111111111111111111111111111111111111111111111111111
