111111111111111111111111111111111111111111111111111111111
100000000000000000000000000000000000000000000000000000001
12E000000000000000000000000000000000000000000000000000001
111111111111111111111111111111111111101110111011101111101
100000000000000000000000000000000000000000000000000000001
1000000000000000000C00000C0000000000000000000000000000001
100000111111111111111110000000000001110111011101110101111
100000000000000000000000000000000000000000000000000000001
100000000000000000000000000000000000000000002220000000001
100000000000000000000000000000000000000000000000000000001
10C000000000000000000000000000000000000000000000000000001
100000111111111111111110000000000001110111011101110101111
100000000000000000000000000000000000000000000000000000001
100000000000000000022200000000000000000000000000000000001
100000000000000000000000000000000000000000000000000000001
10C000000000000000000000000000000000000000000000000000001
111111111111100000000000000000000000000000000000000000001
100000000000000000000000000000000000000000000000000000001
100000000000000000000001111111111110001000100010001010001
1000000P0000000000000000000000000000000000000000000000001
111111111111111111111111111111111111111111111111111111111
