11111111111111111111111111111111111111111
11111111111111111111111111111111111111111
11000000000F0F000000000000000000000000011
110E0000000000000000000000000000000000011
11WWWWWWWWWWWWWWWWWWWWWWWWWWWWWWWWWWWWY11
11000000F0F0F0F0F000000000000000000000Y11
11000000000000000000C00000000000000000Y11
110000YWWWWWWWWWWWWWWWWWY0000000000YWWW11
110000Y00000000000000000Y0000000000Y00011
110000Y00000000000000000Y0000000000Y00011
110000Y00000F00000000000Y0000000000Y00011
110C00Y00000000000000000Y0000000000Y00011
11WWWWWWWWWWWWY000000000Y0000000000Y00011
11000000000000Y000000000Y0000000000Y00011
1100F000000000Y000F00000WWWWWWWWWWWW00011
11000000P00000Y00000000000000000000000011
11111111111111111111111111111111111111111
11111111111111111111111111111111111111111