111111111111111111111111111111111111111
100000000000000000000000000000000000001
120000000E00000000000000000000000000001
111111111111111110111111111111111111101
101000000000011110111000000000000000001
111000000000000001000000000000000000001
10000000000C000000000000000000000001111
10000000000C0000000C0000000000000110001
10000000C00C000000000000000000000000001
10000000000C000000000000000000000000001
10000000000C000000000000000000000000001
111111111111100000000000000000000000001
100000000000000000000000000000000000001
100000000000000000000000000000000000001
1000000P0000000000000000000000000000001
111111111111111111111111111111111111111