111111111111111111111111111111111111111
1000000000F0F00000000000000000000000001
10E000000000000000000000000000000000001
1WWWWWWWWWWWWWWWWWWWWWWWWWWWWWWWWWWWWY1
1000000F0F0F0F0F000000000000000000000Y1
1000000000000000000C00000000000000000Y1
10000YWWWWWWWWWWWWWWWWWY0000000000YWWW1
10000Y00000000000000000Y0000000000Y0001
10000Y00000000000000000Y0000000000Y0001
10000Y00000F00000000000Y0000000000Y0001
10C00Y00000000000000000Y0000000000Y0001
1WWWWWWWWWWWWY000000000Y0000000000Y0001
1000000000000Y000000000Y0000023450Y0001
100F000000000Y000F00000WWWWWWWWWWWW0001
1000000P00000Y0000000000000000000000001
111111111111111111111111111111111111111